Orth	Phon
a 	a
b 	b
ch 	tʃ
d 	d
e 	e
f 	f
g 	ɡ
gb 	ɡ͡b
gb	~ɠ͡ɓ
gh 	ɣ
gw 	ɡʷ
h 	ɦ
i 	i
ị 	ɪ̙
j 	dʒ
k 	k
kp 	k͡p
kp 	ƙ͡ƥ
kw 	kʷ
l 	l
m 	m
n 	n
ṅ 	ŋ
nw 	ŋʷ
ny 	ɲ
o 	o
ọ 	ɔ̙
p 	p
r 	ɹ
s 	s
sh 	ʃ
t 	t
u 	u
ụ 	ʊ̙
v 	v
w 	w
y 	j
z 	z
